%s used of %s %s %%=%s تستخدم %s (%s %%)
---=تستخدم
Active tunnels=القنوات النشطة
Activity=النشاط
ago=مُنذ
Airflow=تدفق الهواء
All Apps=جميع التطبيقات
All VMs=جميع الأجهزة الافتراضية
Battery charge=شحن البطارية
BIOS dated=مؤرخ Bios
Click to toggle details=انقر لتغيير التفاصيل
Completed=مكتمل
Counters info=معلومات المؤشرات
Current operation %s on %s=العملية الحالية %s على **%s**
custom image=تخصيص صورة
Data is invalid=البيانات غير صحيحة
default image=الصورة الافتراضية
Docker Containers=حاويات دوكر
Due in=مستحق في
Elapsed time=الوقت المنقضي
Errors info=معلومات الأخطاء
Estimated finish=الوقت المفترض للانتهاء
failed device=جهاز معطل
Fan count=عدد المراوح
FAN=مروحة
Finding %s error=جاري البحث عن **%s**الخطأ
Finding %s errors=جاري البحث عن **%s** الاخطاء
General info=معلومات عامة
Go to cache settings=الانتقال إلى إعدادات التخزيت المؤقت
Go to CPU pinning settings=الانتقال إلى إعدادت تثبيت وحدة المعالجة المركزية
Go to disk settings=الانتقال إلى إعداداتالقرص
Go to Docker settings=الانتقال إلى إعدادات دوكر
Go to fan settings=الانتقال إلى إعدادات المروحة
Go to identification settings=الانتقال إلى إعدادات التعريف
Go to network settings=الانتقال إلى إعدادات الشبكة
Go to scheduler settings=الانتقال إلى إعدادات الجدول
Go to Share settings=الانتقال إلى إعدادات المشاركة
Go to UPS settings=الانتقال إلى إعدادات UPS
Go to User settings=الانتقال إلى إعدادات المستخدم
Go to VM settings=الانتقال إلى إعدادات الجهاز الافتراضي
Go to VPN settings=VPN الانتقال إلى إعدادات
Handshake=المصافحة
has=لدى
healthy=صحي
heat warning=تحذير من الحرارة
Hide details=اخف التفاصيل
in progress=جاري العمل
Inactive tunnels=قنوات غير نشطة
inactive=غير نشط
Inbound=وارد
invalid device=جهاز غير صالح
invalid devices=أجهزة غير صالحة
Last check completed on %s=الفحص الأخير انتهى في**%s**
Last check incomplete on %s=الفحص الأخير لم ينته **%s**
Last checked on %s=آخر فحص كان في **%s**
Maximum size=اأقصى حجم مسموح به
Mode of operation=وضع التشغيل
Next check scheduled on %s=جدولة الفحص القادم في  **%s**
No docker containers defined=لم يتم التعرف على حاويات دوكر
No running docker containers=لا توجد حاويات دوكر عاملة
No running virtual machines=لا توجد أجهزة افتراضية عاملة
No shares present=لا توجد مشاركات
No virtual machines defined=لم يتم التعرف على الأجهزة الافتراضية
Nominal power=الطاقة الاسمية
not received=غير مستلم
Outbound=الصادر
Overall Load=الحمل الكُلي
Parity disk not present=القرص التماثلي غير موجود
Parity disks not present=الأقراص التماثلية غير موجودة
Parity has not been checked yet=لم يتم التحقق من التمائل لحد الآن
Parity is degraded=تخفيض التمائل
Power=الطاقة
Put system to sleep=ضع النظام على وضع السكون
Reboot the system=إعادة تشغيل النظام
Receive counters=المؤشرات المُستلمة
Received packets=الحزم المُستلمة
Runtime left=وقت التشغيل المُتبقي
Scheduled parity check is disabled=جدولة فحص التمائل معطلة
Select Case Model=اختر نوع الحالة
Share count %s with %s cache only and %s encrypted=عدد المشاركات: %s مع %s  ذاكرة التخزين المؤقتة فقط %s مشفرة
Show details=عرض التفاصيل
Show Information=عرض المعلومات
Shutdown the system=إيقاف تشغيل النظام
SMART error=خطأ في تكنولوجيا SMART
SMART=تكنولوجيا SMART
sn=s/n
Start the array=تشتغيل المصفوفة
Started only=بدء فقط
Stop the array=إيقاف المصفوفه
This will put the system to sleep=هذا سيؤدي لوضع النظام في وضع السكون
This will reboot the system=هذا سيؤدي لإعادة تشغيل النظام
This will shutdown the system=هذا سيؤدي لإيقاف تشغيل النظام
This will start the array=هذا سيؤدي لتشغيل المصفوفة
This will stop the array=هذا سيؤدي لإيقاف المصفوفة
Transmit counters=مؤشرات الإرسال
Transmitted packets=الحُزم المُرسلة
UPS Load=حمل وحدة UPS
UPS status=حالة وحدة UPS
Usable size=الحجم الصالح للاستخدام
User count %s with %s unprotected=عدد المستخدمين: %sمع %s غير محمي
utilization warning=تحذير الاستخدام
View Running Processes=عرض العلميات الجارية
Virtual Machines=الأجهزة الافتراضية

; New entries - 2021-03-14
Temp=
