Access Mode=وضع الوصول
Add another Path, Port, Variable, Label or Device=أضف مسار، منفذ، متغير، تسمية، أو جهاز
Add Configuration=أضف تكوينات
Add=أضف
Always=دائمًا
App to Host=تطبيق إلى المضيف
Application=تطبيق
apply update=تطبيق التحديث
Array must be Started to view Docker containers=يجب **بدء** المصفوفة لإظهار حاويات دوكر
Are you sure=هل أنت متأكد
Autostart=بدء تلقائي
Back=خلف
Backup=نسخة احتياطية
Beta=بيتا
Books=كتب
By=بواسطة
Categories=فئات
Check for Updates=تأكد من التحديثات
Cloud=سحاب
Config Type=نوع التكوين
Configuration not found=لا يوجد تكوينات
Connection Type=نوع الاتصال
Console shell command=أوامر وحدة التحكم
Container ID=معرف الحاوية
Container Path=مسار الحاوية
Container Port=منفذ الحاوية
Container Size=حجم الحاوية
Container=الحاوية
CPU Memory load=تحميل وحدة المعالجة المركزية والذاكرة
CPU Pinning=تثبيت وحدة المعالجة المركزية
Created=إنشاء
Default Value=قيمة افتراضية
Device=جهاز
Display=عرض
DNS=DNS
Docker Containers=
Docker Hub URL=رابط DockerHub
Docker Service failed to start=فشل تفعيل خدامات دوكر
Donation Link=رابط التبرع
Donation Text=نص التبرع
Downloaders=أدوات التنزيل
Edit Configuration=تعديل التكوينات
Exited=تم الخروج
Extra Parameters=معلمات إضافية
Fixed IP address=عنوان IP ثابت
force update=فرض التحديث
FTP=FTP
Game Servers=خوادم الألعاب
healthy=سليمة
Hide Buttons=إخفاء الأزرار
Hide docker allocations=إخفاء تخصيصات دوكر
Hide more settings=إخفاء المزيد من الإعدادات
Home Automation=أنظمة تحكم منزلية تلقائية
Host Path=مسار المضيف
Host Port=منفذ المضيف
HT=HT
Icon URL=رابط أيقونة
Image ID=رابط الصورة
Key=مفتاح
Label=تسمية
latest=الأحدث
Management=الإدارة
MediaApp=تطبيق وسائط
MediaServer=خادم وسائط
Messenger=المراسلة
Missing parameters=معلمات مفقودة
Music=موسيقى
Network Type=نوع الشبكة
No Docker containers installed=ما من حاويات دوكر مثبتة
of=من
orphan image=صورة وحيدة
Other=أخرى
Overview=‏‏نظرة عامة
Path=مسار
Pause All=إيقاف الكل
Photos=صور
Port Mappings=تعيينات المنافذ
Port=منفذ
Post Arguments=وسيطات
Privileged=متميزة
Productivity=الإنتاجية
Project Page=صفحة المشروع
Proxy=وكيل
Pulling image=سحب صورة
Read Only - Shared=للقراءة فقط - مشترك
Read Only - Slave=للقراءة فقط - تابع
Read Only=للقراءة فقط
ReadWrite - Shared=قراءة/كتابة - مشترك
ReadWrite - Slave=قراءة/كتابة - تابع
rebuild ready=إعادة البناء جاهزة
rebuilding=إعادة البناء
Remove template=إزالة قالب
Removing container=إزالة حاوية
Removing orphan image=إزالة صورة وحيدة
Repository=مستودع
Required=مطلوب
Resume All=استئناف الكل
Save=حفظ
Select a template=تحديد قالب
Select categories=تحديد فئة
Show docker allocations=إظهار تخصيصات دوكر
Show more settings=إظهار المزيد من الإعدادات
Stable=مستقر
Start All=بدء الكل
starting up containers=بدء الحاويات
Stop All=وقف الكل
Stopping container=إيقاف حاوية
Successfully removed container=تم إزالة الحاوية بنجاح
Successfully removed orphan image=تم إزالة الصورة الوحيدة بنجاح
Successfully stopped container=تم إيقاف الحاوية بنجاح
Support Thread=مؤشر ترابط الدعم
Template repositories=مستودعات القوالب
Template URL=رابط القالب
Template=قالب
The command failed=فشل الأمر
The command finished successfully=نجاح الأمر النهائي
TOTAL DATA PULLED=**إجمالي البيانات المسحوبة**
Unknown action=أمر غير معروف
Update All=تحديث الكل
update ready=التحديث جاهز
Value=قيمة
Variable=متغير
Video=فيديو
Voip=VOIP
Volume Mappings=تعيينات وحدة تخزين
wait=انتظر
Was this container created using this plugin=هل تم إنشاء الحاوية باستخدام هذا المكون الإضافي
Web=ويب
WebUI=WebUI
Writable=قابل للكتابة

; New entries - 2021-03-14
Drivers=
Reset sorting=
Start Container After Install=

; New entries - 2021-03-14
Total size=
