also remove image=أزل الصورة أيضًا
Apply=تطبيق
Are you sure=هل أنت واثق؟
Cancel=إلغاء
checking=جار الفحص
Completely REMOVE=أزل كليًا
Console=وحدة تحكم
day=اليوم
days=الأيام
disk image and definition=صورة القرص وتعريفه
Disks=الأقراص
Donate=
Done=منجز
Edit=تحرير
Execution error=خطأ في التنفيذ
Force Stop=توقف إجباري
Hibernate=إسبات
Log for=سجل لـ
log=سجل
Logs=السجلات
More Info=مزيد من المعلومات
No=لا
OK=موافق
Ok=موافق
Pause=إيقاف مؤقت
Proceed=متابعة
Project Page=صفحة المشروع
Read Me First=
Remove container=إزالة الحاوية
Remove definition=إزالة التعريف
Remove image=إزالة الصورة
Remove VM=إزالة الجهاز الافتراضي
Remove=إزالة
Restart=إعادة التشغيل
Resume=استئناف
Start=بدء
Stop=توقف
Support=الدعم
Update container=تحديث الحاوية
Update=تحديث
Updating all Containers=تحديث جميع الحاويات
Updating the container=جار تحديث الحاوية
VNC Remote=VNC عن بعد
WebUI=واجهة المستخدم الشبكية
Yes, delete it=نعم، احذفه!
Yes, update it=نعم، قم بتحديثه!
Yes=نعم

; footer messages
Array Copying=
Array Clearing=
Array Starting=جار بدء المصفوفة
Array Stopping=جار إيقاف المصفوفة
Mounting disks=تحميل الأقراص
Spinning up all drives=تنشيط دوران جميع الأقراص
Starting services=بدء تشغيل الخدمات
Stopping services=إيقاف الخدمات
Unmounting disks=تنزيل الأقراص
Autostart disabled=تم تعطيل التشغيل التلقائي
Missing encryption key=مفتاح التشفير مفقود
Opening encrypted volumes=فتح وحدات تخزين المشفرة

; docker variables
Container Path=
Container Port=
Container Variable=
Container Label=
Container Device=

; Note: March 18, 2022 - 9 missing translations
