%s An update is available=%s: يتوفر تحديث
anonymous=مجهول
Author=مؤلف
Check For Updates=تحقق من وجود تحديثات
Click here to install version %s=انقر هنا لتثبيت الإصدار %s
DOWNGRADE TO VERSION=رجوع إلى الإصدار
Enter URL of remote plugin file or local plugin file=أدخل رابط ملف الملحق الإضافي أو الملف المحلي للملحق الإضافي
ERROR=خطأ
Install Plugin=تثبيت الملحق الإضافي
install=تثبيت
Install=تثبيت
Installed Plugins=الملحقات المثبتة
Installing Update=جاري تثبيت التحديث
need check=بحاجة لتحقق
Next=التالي
No release notes available=ملاحظات الإصدار غير متاحة
Plugin File=ملف الملحق الإضافي
Plugin Update Check=تحقق من تحديثات الملحقات الإضافية
Plugin=الملحقات الإضافية
Release Notes=ملاحظات الإصدار
remove=إزالة
Select local plugin file=حدد ملف الملحق الإضافي المحلي
Stable=مستقر
STALE=تالف
Support Thread=خط الدعم
Uninstall=إلغاء التثبيت
Update All Plugins=تحديث كل الملحقات الإضافية
Upgrade=ترقية
View Release Notes=عرض ملاحظات الإصدار

; New entries (1) - 2021-05-08
No plugins installed=
