Add Share=أضف مشاركة
All files encrypted=جميع الملفات مشفرة
All files protected=جميع الملفات محمية
All files unprotected=جميع الملفات غير محمية
Allocation method=طريقة التخصيص
Array must be Started to view Shares=يجب **تشغيل** المصفوفة لعرض المشاركات
Automatically split any directory as required=تقسيم أي دليل تلقائيًا حسب المطلوب
Automatically split only the top five directory levels as required=التقسيم التلقائي لمستويات الدليل الخمسة الأوائل فقط حسب المطلوب
Automatically split only the top four directory levels as required=التقسيم التلقائي لمستويات الدليل الأربعة الأوائل فقط حسب المطلوب
Automatically split only the top level directory as required=التقسيم التلقائي لمستوى الدليل الأول فقط حسب المطلوب
Automatically split only the top three directory levels as required=التقسيم التلقائي للمستويات الدليل الثلاث الأوائل فقط حسب المطلوب
Automatically split only the top two directory levels as required=التقسيم التلقائي للمستويين الدليل الأولين فقط حسب المطلوب
Comments=ملاحظات
Compute All=حساب الكل
Compute=حساب
Disk Shares=مشاركات القرص
Do not use reserved names=لا تستخدم الأسماء المحجوزة
Do not use pool names=لا تستخدم أسماء التجمع
Enable Copy-on-write=تمكين النسخ عند الكتابة
Enter a name for the share=أدخل اسمًا للمشاركة
Excluded disks=الأقراص المستبعدة
Export=تصدير
Fill-up=التعبئة
Free=شاغر
has been deleted=تم حذفه
HDD=القرص الصلب
High-water=المياه العالية
Included disks=الأقراص المضمنة
Invalid Characters=أحرف غير صالحة
Invalid share name=اسم المشاركة غير صالح
Manual do not automatically split directories=يدوي: لا تقم بالتقسيم التلقائي للدلائل
Minimum free space=الحد الأدنى من المساحة الشاغرة
Missing share name=اسم المشاركة مفقود
Most-free=الأكثر مساحة
Mover takes no action=الناقل لا يتخذ أي إجراء
Mover transfers files from array to cache=ينقل الناقل الملفات من المصفوفة إلى ذاكرة التخزين المؤقت
Mover transfers files from cache to array=ينقل الناقل الملفات من ذاكرة التخزين المؤقت إلى المصفوفة
next user share=مشاركة المستخدم التالي
Only=فقط
Prefer=مفضل
previous user share=مشاركة المستخدم السابق
Read=قراءة
Recompute=إعادة حساب
Rule=قاعدة
Select cache pool=حدد تجمع التخزين المؤقت
Set when adding new share only=تعيين عند إضافة مشاركة جديدة فقط
Share contains data=مشاركة تحتوي على بيانات
Share is empty=المشاركة فارغة
Share is outside the list of designated disks=المشاركة خارج قائمة الأقراص المعينة
Share Settings=إعدادات المشاركة
Share status=حالة المشاركة
Size=السعة
Some or all files unencrypted=بعض أو جميع الملفات غير مشفرة
Some or all files unprotected=بعض أو جميع الملفات غير محمية
Split level=مستوى التقسيم
SSD=محرك الأقراص ذي الحالة الصلبة
There are no exportable disk shares=لا توجد مشاركات قرص قابلة للتصدير
There are no exportable user shares=لا توجد مشاركات مستخدم قابلة للتصدير
Time Machine volume size limit=حد سعة حجم آلة الزمن
Unknown encryption state=حالة التشفير غير معروفة
Use cache pool for new filesdirectories=استخدام تجمع التخزين المؤقت لملفات/الدلائل الجديدة
User Shares=مشاركات المستخدم
Write=كتابة
You cannot use the following within share names=لا يمكنك استخدام ما يلي ضمن أسماء المشاركة
