20 EHCI=2.0 (EHCI)
30 nec XHCI=3.0 (nec XHCI)
30 qemu XHCI=3.0 (qemu XHCI)
Allocation=التوزيع
and if using graphics device passthrough it too needs UEFI=وإذا كنت تستخدم تمرير جهاز الرسومات فإنه يحتاج أيضًا إلى UEFI
Are you sure=هل أنت متأكد
Array must be started to view Virtual Machines=يجب **تشغيل** المصفوفة لعرض الأجهزة الافتراضية
Autostart=التشغيل التلقائي
Back=رجوع
Bus=ناقل
Capacity=السعة
Change Icon=تغيير الأيقونة
Cleanup=تنظيف
Click and Select cdrom image to install operating system=انقر وحدد صورة القرص المدمج لتثبيت نظام التشغيل
Config Folder=مجلد التكوين
Copy Paste Domain XML Configuration Here=نسخ ولصق تهيئة النطاق هنا (لغة الترميز القابلة للامتداد XML)
CPU Mode=وضع وحدة المعالجة المركزية
CPUs=وحدات المعالجة المركزية
Create=إنشاء
Creating=جاري الإنشاء
define the amount memory=تحديد سعة الذاكرة
define the maximum amount of memory=تحديد الحد الأقصى لسعة الذاكرة
define type of cpu presented to this vm=تحديد نوع وحدة المعالجة المركزية المقدمة إلى هذا الجهاز الافتراضي
description of virtual machine=وصف الجهاز الافتراضي
Disk devices=أجهزة القرص
Download Folder=مجلد التحميل
Download, Click and Select virtio drivers image=تنزيل، انقر واختر صورة برامج تشغيل الإدخال والإخراج الافتراضي
Downloading=جاري التنزيل
eg=على سبيل المثال
Emulated=تمت مضاهاته
Extracting=جاري الاستخراج
Folder to save the LibreELEC image to=مجلد لحفظ صورة LibreELEC
Folder to save the OpenELEC image to=مجلد لحفظ صورة OpenELEC
Form View=عرض النموذج
free=المساحة الفارغة
Graphics Card=بطاقة الرسومات
Graphics ROM BIOS=النظام الأساسي للإدخال والإخراج لبطاقة الرسومات
Graphics=الرسومات
Host Passthrough=عبر المضيف
Hyperv tweaks for Windows=تعديلات Hyperv لنظام التشغيل ويندوز
Hyper-V=Hyper-V
i440fx will work for most=سوف يعمل i440fx للأغلبية
Icon=أيقونة
Initial=أولي
Invalid VM to edit=جهاز افتراضي غير صالح للتعديل
ISO storage path doesnt exist=مسار تخزين أيزو غير موجود
ISO storage path was empty=كان مسار تخزين أيزو فارغًا
keyboard for VNC=لوحة المفاتيح للحوسبة الشبكية الافتراضية
LibreELEC Version=إصدار LibreELEC
LibreELEC=LibreELEC
Libvirt Service failed to start=فشل في تشغيل خدمة Libvirt
Logical CPUs=وحدات المعالجة المركزية المنطقية
Machine=آلة
Manual=يدوي
Max=أقصى
MD5 verification failed, your download is incomplete or corrupted=فشل التحقق من MD5 ،التنزيل غير مكتمل أو تالف
mount tag inside vm=تحميل العلامة داخل الجهاز الافتراضي
My Workstation=محطة عملي
name of mount tag inside vm=اسم علامة التثبيت داخل الجهاز الافتراضي
Name of virtual machine=اسم الجهاز الافتراضي
Network Bridge=جسر الشبكة
Network MAC=عنوان التحكم بالنفاذ للوسط للشبكة
Network Model=
No Virtual Machines installed=لم يتم تثبيت أجهزة افتراضية
None available=غير متوفر
Not enough free space, need at least=لا توجد مساحة حرة كافية، تحتاج على الأقل
Not running=لا يعمل
OpenELEC Version=إصدار OpenELEC
OpenELEC=OpenELEC
OS Install CDRom Bus=ناقل القرص المدمج الخاص بتثبيت نظام التشغيل
OS Install ISO=أيزو الخاص بتثبيت نظام التشغيل
Other PCI Devices=أجهزة طرفية أخرى
OVMF requires a UEFI-compatable OS=يتطلب OVMF نظام تشغيل متوافق مع UEFI
OVMF=OVMF
password for VNC=كلمة المرور للحوسبة الشبكية الافتراضية
path of Unraid share=مسار مشاركة اونريد
path on Unraid share to save LibreELEC settings=المسار على مشاركة اونريد لحفظ إعدادات LibreELEC
path on Unraid share to save OpenELEC settings=المسار على مشاركة اونريد  لحفظ إعدادات OpenELEC
Path to ROM BIOS file=المسار إلى ملف قرص النظام الأساسي للإدخال والإخراج
Please choose a folder the LibreELEC image will download to=الرجاء اختيار مجلد ليتم تنزيل صورة LibreELEC عليه
Please choose a folder the OpenELEC image will download to=الرجاء اختيار مجلد ليتم تنزيل صورة OpenELEC عليه
Primary=أساسي
Q35 for a newer machine model with PCIE=Q35 لنموذج آلة أحدث مع PCIE
QEMU64=QEMU64
random mac, you can supply your own=mac عشوائي، يمكنك استعمال خاصتك
re-generate random mac address=إعادة إنشاء عنوان mac عشوائي
Remove LibreELEC image=إزالة صورة LibreELEC
Remove OpenELEC image=إزالة صورة OpenELEC
Remove this LibreELEC file=إزالة ملف LibreELEC
Remove this OpenELEC file=إزالة ملف OpenELEC
SeaBIOS will work for most=SeaBIOS سيعمل لمعظم
SeaBIOS=SeaBIOS
Select the BIOS=حدد النظام الأساسي للإدخال والإخراج
Select the LibreELEC version to use=حدد إصدار LibreELEC للاستخدام
Select the machine model=حدد طراز الجهاز
Select the OpenELEC version to use=حدد إصدار OpenELEC لاستخدامه
Select the USB Controller to emulate=حدد وحدة تحكم USB لتتم مضاهاته
Separate sub-folder and image will be created based on Name=سيتم إنشاء مجلد فرعي منفصل وصورة حسب الاسم
shares=المشاركات
Some OSes wont support USB3=لن تدعم بعض أنظمة تشغيل USB3
Sound Card=بطاقة الصوت
Start All=بدء الكل
Start VM after creation=بدء الجهاز الافتراضي بعد الانشاء
Stop All=إيقاف الكل
Toggle VM autostart=تبديل التشغيل التلقائي للجهاز الافتراضي
type of storage image=نوع صورة التخزين
Unknown action=إجراء غير معروف
Unknown version=إصدار غير معروف
Unraid Mount tag=علامة تثبيت اونريد
Unraid Share=مشاركة اونريد
Updating=جاري التحديث
USB Controller=متحكم USB
USB Devices=أجهزة USB
vDisk Bus=ناقل القرص الافتراضي
vDisk Location=موقع القرص الافتراضي
vDisk Size=سعة القرص الافتراضي
vDisk Type=نوع القرص الافتراضي
vDisks=الأقراص الافتراضية
video for VNC=فيديو للحوسبة الشبكية الافتراضية
VirtIO Drivers CDRom Bus=تعريفات الإدخال و الإخراج الافتراضي لناقل القرص المدمج
VirtIO Drivers ISO=أيزو تعريفات الادخال و الإخراج الافتراضي
Virtual Machines=الأجهزة الافتراضية
VM creation error=خطأ في إنشاء الجهاز الافتراضي
VM image deletion error=خطأ في حذف صورة الجهاز الافتراضي
VNC Keyboard=لوحة مفاتيح الحوسبة الشبكية الافتراضية
VNC Password=كلمة مرور الحوسبة الشبكية الافتراضية
VNC Video Driver=مشغل فيديو الحوسبة الشبكية الافتراضية
VNC=الحوسبة الشبكية الافتراضية
Wasnt able to stop the process=لم يتم التمكن من إيقاف العملية
Windows 7XP=ويندوز XP7
Windows 82012, newer Linux distros=ويندوز 8/2012، توزيعات لينوكس الأحدث
XML View=عرض XML
